alias a='adb'

alias ade='adb devices'
alias ash='adb shell'
alias aro='adb root'
alias adv='adb disable-verity'
alias arm='adb remount'
alias arb='adb reboot'
alias acn='adb connect'
alias adc='adb disconnect'
alias ass='adb start-server'
alias aks='adb kill-server'
alias av='adb version'
alias asc='adb shell screencap -p'
alias adp='adb shell dumpsys package'
alias apr='adb shell procrank'
alias ati='adb tcpip'
alias asql3='adb shell sqlite3'
alias aenv='adb shell env'

# ????
alias aps='adb push'
alias apl='adb pull'
alias acm='adb shell chmod 777'
alias amd='adb shell mkdir'
alias arm='adb shell rm -r'
alias amv='adb shell mv'
alias arn='adb shell rename'
alias acp='adb shell cp'
alias acat='adb shell cat'
alias alsa='adb shell ls -al'

#pm??
alias ap='adb shell pm'
alias app='adb shell pm path'
alias apd='adb shell pm dump'
alias aplf='adb shell pm list features'
alias apll='adb shell pm list libraries'
alias aplpa='adb shell pm list packages'
alias aplpe='adb shell pm list permission'
alias aplpeg='adb shell pm list permission-groups'
alias apra='adb shell pm resolve-activity'
alias apqa='adb shell pm query-activities'
alias apqs='adb shell pm query-services'
alias apqr='adb shell pm query-receivers'
alias api='adb shell pm install -r -t -d'
alias apic='adb shell pm install-create'
alias apiw='adb shell pm install-write'
alias apic='adb shell pm install-commit'
alias apia='adb shell pm install-abandon'
alias apsil='adb shell pm set-install-location'
alias apgil='adb shell pm get-install-location'
alias apmp='adb shell pm move-package'
alias apmps='adb shell pm move-primary-storage'
alias apui='adb shell pm uninstall'
alias apc='adb shell pm clear'
alias ape='adb shell pm enable'
alias apd='adb shell pm disable'
alias apdu='adb shell pm disable-user'
alias apduu='adb shell pm disable-until-used'
alias apds='adb shell pm default-state'
alias aph='adb shell pm hide'
alias apuh='adb shell pm unhide'
alias aps='adb shell pm suspend'
alias apus='adb shell pm unsuspend'
alias apg='adb shell pm grant'
alias apr='adb shell pm revoke'
alias aprp='adb shell pm reset-permissions'
alias apspe='adb shell pm set-permission-enforced'
alias apgpp='adb shell pm get-privapp-permissions'
alias apgpdp='adb shell pm get-privapp-deny-permissions'
alias apgop='adb shell pm get-oem-permissions'
alias apsal='adb shell pm set-app-link'
alias apgal='adb shell pm get-app-link'
alias aptc='adb shell pm trim-caches'
alias apcu='adb shell pm create-user'
alias apru='adb shell pm remove-user'
alias apsur='adb shell pm set-user-restriction'
alias apgmu='adb shell pm get-max-users'
alias apgmru='adb shell pm get-max-running-users'
alias apc='adb shell pm compile'
alias apfdo='adb shell pm force-dex-opt'
alias apbdj='adb shell pm bg-dexopt-job'
alias aprsdf='adb shell pm reconcile-secondary-dex-files'
alias apdp='adb shell pm dump-profiles'
alias apsp='adb shell pm snapshot-profile'
alias apsha='adb shell pm set-home-activity'
alias apsi='adb shell pm set-installer'
alias apgir='adb shell pm get-instantapp-resolver'
alias apshaw='adb shell pm set-harmful-app-warning'
alias apghaw='adb shell pm get-harmful-app-warning'
alias apusu='adb shell pm uninstall-system-updates'
alias apusu='adb shell pm uninstall-system-updates'

#am??
alias aa='adb shell am'
alias aasa='adb shell am start-activity'
alias aasts='adb shell am start-service'
alias aasfs='adb shell am start-foreground-service'
alias aasps='adb shell am stop-service'
alias aab='adb shell am broadcast'
alias aai='adb shell am instrument'
alias aati='adb shell am trace-ipc'
alias aap='adb shell am profile'
alias aadh='adb shell am dumpheap'
alias aasda='adb shell am set-debug-app'
alias aacda='adb shell am clear-debug-app'
alias aaswh='adb shell am set-watch-heap'
alias aacwh='adb shell am clear-watch-heap'
alias aabr='adb shell am bug-report'
alias aafs='adb shell am force-stop'
alias aac='adb shell am crash'
alias aak='adb shell am kill'
alias aak='adb shell am kill-all'
alias aamui='adb shell am make-uid-idle'
alias aam='adb shell am monitor'
alias aawu='adb shell am watch-uids'
alias aah='adb shell am hang'
alias aars='adb shell am restart'
alias aaim='adb shell am idle-maintenance'
alias aasc='adb shell am screen-compat'
alias aapi='adb shell am package-importance'
alias aatu='adb shell am to-uri'
alias aatiu='adb shell am to-intent-uri'
alias aatau='adb shell am to-app-uri'
alias aaswu='adb shell am switch-user'
alias aagcu='adb shell am get-current-user'
alias aastu='adb shell am start-user'
alias aauu='adb shell am unlock-user'
alias aapu='adb shell am stop-user'
alias aaius='adb shell am is-user-stopped'
alias aagsus='adb shell am get-started-user-state'
alias aata='adb shell am track-associations'
alias aauta='adb shell am untrack-associations'
alias aagus='adb shell am get-uid-state'
alias aaaa='adb shell am attach-agent'
alias aagc='adb shell am get-config'
alias aasm='adb shell am supports-multiwindow'
alias aasssmw='adb shell am supports-split-screen-multi-window'
alias aasrcc='adb shell am suppress-resize-config-changes'
alias aasi='adb shell am set-inactive'
alias aagi='adb shell am get-inactive'
alias aassb='adb shell am set-standby-bucket'
alias aagsb='adb shell am get-standby-bucket'
alias aastm='adb shell am send-trim-memory'
alias aad='adb shell am display'
alias aas='adb shell am stack'
alias aat='adb shell am task'
alias aaua='adb shell am update-appinfo'
alias aaw='adb shell am write'

#wm??
alias aw='adb shell wm'
alias aws='adb shell wm size'
alias awd='adb shell wm density'
alias awo='adb shell wm overscan'
alias awsc='adb shell wm scaling'
alias awdk='adb shell dismiss-keyguard'
alias awt='adb shell tracing'

#dumpsys??
alias ads='adb shell dumpsys'
alias adsmi='adb shell dumpsys meminfo'
alias adsci='adb shell dumpsys cpuinfo'
alias adsps='adb shell dumpsys procstats'
alias adsbs='adb shell dumpsys batterystats'
alias adsp='adb shell dumpsys package'
alias adsgf='adb shell dumpsys gfxinfo'
alias adsw='adb shell dumpsys window'
alias adsww='adb shell dumpsys window windows'
alias adsl='adb shell dumpsys -l'

#logcat??
alias al='adb logcat'
alias alt='adb logcat -v time'
alias alg='adb logcat | grep'
alias als='adb logcat -s'
alias alv='adb logcat "*:V"'
alias ald='adb logcat "*:D"'
alias ali='adb logcat "*:I"'
alias alw='adb logcat "*:W"'
alias ale='adb logcat "*:E"'
alias alc='adb logcat -c'

#input??
alias ai='adb shell input'
alias aik='adb shell input ketevent'
alias aitt='adb shell input text'
alias aitp='adb shell input tap'
alias ais='adb shell input swipe'
alias aidd='adb shell input draganddrop'
alias aidd='adb shell input draganddrop'
alias aip='adb shell input press'
alias air='adb shell input roll'

#sm??
alias as='adb shell sm'
alias asld='adb shell sm list-disks'
alias asld='adb shell sm sm list-volumes'

# custome 
alias adem='while true; do adb devices;  sleep 1; done;'
alias screenshot="adb shell screencap -p /sdcard/screencap.png && adb pull /sdcard/screencap.png screencap.png"
alias startintent="adb devices | tail -n +2 | cut -sf 1 | xargs -I X adb -s X shell am start $1"                                                             ¦/system/bin/sh: syntax error: unexpected ';'
alias apkinstall="adb devices | tail -n +2 | cut -sf 1 | xargs -I X adb -s X install -r $1"                                                                  ¦1|dcy11:/system/app $ ls
alias rmapp="adb devices | tail -n +2 | cut -sf 1 | xargs -I X adb -s X uninstall $1"                                                                        ¦AIXiaokaGUI            CtsShimPrebuilt   KeyChain             SoundRecorder     XCDvr               XCMyVehicle      XCViolation
alias clearapp="adb devices | tail -n +2 | cut -sf 1 | xargs -I X adb -s X shell pm clear $1"